00000000000000000000000000000000
00000000000000000000000000000000
00000000000000000000000000000000
00000000000000000000000000000000
00000011111111111111110000000000
00000010001111111100010000000000
00000010000000000000010000000000
00000010000000000000010000000000
00000014000000000000310000000000
00000014000000000000310000000000
00000014000000000000310000000000
00000014000000000000310000000000
00000014000000000000310000000000
00000014000000000000310000000000
00000014000000000000310000000000
00000010000000000000010000000000
00000010000000000000010000000000
00000010002222222200010000000000
00000011111111111111110000000000
00000000000000000000000000000000
00000000000000000000000000000000
00000000000000000000000000000000
00000000000000000000000000000000
00000000000000000000000000000000
